11111111111
1VVVVVVVV11
1V11VVVV101
1V1CVVV1CC1
11111111111