111111111111111111111111111
1C000000000001100000000000C
101111011111011011111011110
101111C11111011011111C11110
101111011111011011111011110
100000000000000000000000000
101111011011111111011011110
101111011011111111011011110
100000011000011000011000000
100000011000011000011000000
101111011000000000011011110
101111011011100111011011110
100000011010000001011000000
10000001101E0000P1011000000
101111011011111111011011110
101111011000000000011011110
100000011000011000011000000
100000011000011000011000000
101111011011111111011011110
101111011011111111011011110
100000000000000000000000000
101111011111011011111011110
101111C11111011011111C11110
101111011111011011111011110
1C000000000001100000000000C
111111111111111111111111111
1C000000000001100000000000C
101111011111011011111011110
101111C11111011011111C11110
101111011111011011111011110
100000000000000000000000000
101111011011111111011011110
101111011011111111011011110
100000011000011000011000000
100000011000011000011000000
101111011000000000011011110
101111011011100111011011110
100000011010000001011000000
10000001101E0000P1011000000
101111011011111111011011110
101111011000000000011011110
100000011000011000011000000
100000011000011000011000000
101111011011111111011011110
101111011011111111011011110
100000000000000000000000000
101111011111011011111011110
101111C11111011011111C11110
101111011111011011111011110
1C000000000001100000000000C
111111111111111111111111111
