


11111111111
1CC1111E1P1
1CC1111E1P1
1CC1111E1P1
11111111111